9 9 9 9 9 9 9 9 9 9 9 9 9 9 9 9 9 9 9 9 9 9 9 9 9 9 9 9 9 9 9 9 
9 1 1 1 2 1 1 1 1 1 1 1 9 1 1 1 1 1 1 1 1 1 1 1 1 1 1 1 1 1 1 9
9 1 1 1 2 1 1 1 1 1 1 1 9 1 1 1 1 1 1 1 1 1 1 1 1 1 1 1 1 1 1 9
9 1 1 5 1 1 1 1 1 1 1 1 9 1 1 1 1 1 1 1 1 1 1 1 1 1 1 1 1 1 1 9
9 1 1 5 1 1 1 1 1 4 4 1 9 1 1 4 4 4 4 1 1 1 1 1 1 1 1 1 1 1 1 9
9 1 2 5 1 1 2 1 4 4 4 1 9 4 4 4 4 4 4 4 1 1 1 1 1 2 1 1 1 1 1 9 
9 2 3 3 3 2 1 4 4 4 4 1 9 4 4 4 4 4 4 4 4 1 1 1 1 1 2 1 1 1 1 9
9 1 3 2 1 3 4 4 4 4 4 1 9 4 4 4 4 4 4 4 4 4 1 1 2 1 1 1 1 1 1 9
9 1 1 1 1 1 1 1 1 1 1 1 9 4 4 4 4 1 1 1 4 4 1 1 2 2 1 1 1 1 1 9
9 9 9 9 9 9 9 9 9 9 9 9 9 4 4 4 1 1 1 1 4 4 1 1 1 1 1 1 1 1 1 9
9 1 1 2 2 1 4 1 1 1 4 4 4 4 4 4 4 4 4 4 4 4 1 1 1 1 1 1 1 1 1 9
9 1 1 1 1 2 4 1 1 1 4 5 5 5 5 5 5 5 5 5 4 4 1 1 1 1 1 1 1 1 1 9
9 1 1 5 1 5 2 4 1 1 4 5 5 5 5 5 5 5 5 4 4 1 1 1 1 1 1 1 1 1 1 9
9 1 5 5 5 5 5 1 4 1 4 5 5 5 5 5 5 5 4 4 1 1 1 1 1 1 1 1 1 1 1 9
9 5 5 5 5 5 5 5 1 4 4 4 4 4 4 4 4 4 4 1 1 1 1 1 1 1 1 1 1 1 1 9
9 5 5 5 5 5 5 5 1 1 4 1 1 1 1 1 1 4 1 1 1 1 1 1 1 1 1 1 1 1 1 9
9 1 5 5 5 5 5 1 1 1 1 4 4 1 1 4 4 1 1 1 1 1 1 1 1 1 1 1 1 1 1 9
9 1 1 5 5 5 1 1 1 1 1 1 1 4 4 1 1 1 1 1 1 1 1 1 1 1 1 1 1 1 1 9
9 1 1 1 5 1 1 1 1 1 1 1 1 1 1 1 1 1 1 1 1 1 1 1 1 1 1 1 1 1 1 9
9 1 1 1 1 1 1 1 1 1 1 1 1 1 1 1 1 1 1 1 1 1 1 1 1 1 1 1 1 1 1 9
