1 4 9 9 9 9 9 9 9 9 9 9 9 9 9 9 9 9 9 9 9 9 9 9 9 9 9 9 9 9 9 9 
9 4 4 1 4 1 1 3 1 1 1 1 1 4 1 1 1 1 1 1 1 4 1 1 1 1 1 8 2 1 1 9
9 1 4 8 4 2 1 1 3 1 1 1 1 4 1 1 1 1 4 4 4 4 1 1 1 1 5 6 1 1 1 9
9 4 4 4 4 4 8 3 2 8 1 1 1 4 1 1 1 1 4 1 1 4 4 1 1 1 1 1 1 4 4 9
9 4 8 5 1 4 4 4 4 4 4 1 1 4 4 4 4 4 4 1 1 1 4 1 1 1 1 1 4 1 1 9
9 4 2 5 2 1 1 1 4 1 4 1 1 4 4 6 1 4 4 4 1 1 4 1 6 2 1 4 4 1 1 9 
9 4 4 3 3 2 1 4 4 1 4 1 1 4 1 1 4 7 0 8 4 1 4 4 4 4 4 4 1 1 1 9
9 1 4 4 1 3 4 4 4 1 4 4 4 4 1 1 4 1 6 7 2 4 4 4 2 1 1 4 1 1 1 9
9 1 1 4 1 1 1 1 1 1 1 1 1 4 1 4 4 1 1 1 4 4 1 1 2 2 1 4 1 1 1 9
9 1 1 4 4 1 1 2 6 1 1 1 1 4 4 4 1 1 1 1 4 4 1 1 1 1 1 4 1 1 1 9
9 1 1 2 4 1 1 1 1 1 4 4 4 4 4 4 4 4 4 4 4 4 4 4 1 1 1 4 4 4 4 9
9 4 4 4 4 4 4 1 1 1 4 5 5 5 8 5 5 5 5 1 4 4 1 4 4 4 4 4 1 1 1 9
9 1 1 1 1 1 2 4 4 8 2 5 5 5 2 5 5 5 5 4 6 1 1 1 1 1 1 4 1 1 1 9
9 1 5 5 5 5 5 1 4 1 4 5 5 5 3 5 5 5 4 4 1 1 1 2 1 1 1 4 1 1 1 9
9 4 5 5 5 5 5 4 4 4 4 4 4 1 4 4 4 4 4 1 4 1 1 8 3 1 1 4 1 1 1 9
9 4 5 5 5 5 5 4 1 1 4 1 4 1 4 1 1 4 1 1 1 1 1 1 2 1 1 4 1 1 1 9
9 4 4 4 4 4 4 4 1 1 1 4 4 4 4 4 4 4 4 4 1 1 1 1 1 1 1 4 1 1 1 9
9 4 1 5 5 5 1 4 1 1 1 1 1 4 4 1 1 1 1 4 4 1 7 8 1 1 1 4 1 1 1 9
9 4 1 1 5 1 1 4 1 1 1 1 2 8 1 1 1 1 1 1 4 4 4 4 4 4 4 4 4 4 4 9
9 9 9 9 9 9 9 9 9 9 9 9 9 9 9 9 9 9 9 9 9 9 9 9 9 9 9 9 9 9 4 1
